#############
#0**0#  #***#
# #####*#*#*#
#  * # *#0  #
#*#*# # #*#*#
#0 *#* *#  0#
# ### #*###*#
#*  *  0  #*#
# ####### #*#
# #* * * ***#
# # #*# #*#*#
#* A * 0** *#
#############
BP=0
SP=0
FP=0
RP=20
T=180
