#############
#A**0    ***#
# # #*#*#*#*#
#  * * * 0  #
#*#*# # #*#*#
#0 * * **   #
# # # #*#*# #
#*  *  0    #
# # # # # # #
#  * * * *  #
# #*#*# #*# #
#0   *  ** *#
#############
BP=3
SP=4
FP=5
RP=0
T=180
